??使用C?言编程，中断查询次?号?是中断号，例?：
void  Int0_Routine(void)      	interrupt 0;
void  Timer0_Rountine(void)    	interrupt 1;
void  Int1_Routine(void)      	interrupt 2;
void  Timer1_Rountine(void)   	interrupt 3;
void  UART1_Routine(void)     	interrupt 4;
void  ADC_Routine(void)       	interrupt 5;
void  LVD_Routine(void)      	interrupt 6;
void  PCA_Routine(void)  	interrupt 7;
void  UART2_Routine(void)  	interrupt 8;
void  SPI_Routine(void) 	interrupt 9;
void  Int2_Routine(void) 	interrupt 10;
void  Int3_Routine(void) 	interrupt 11;
void  Timer2_Routine(void) 	interrupt 12;
void  Int4_Routine(void) 	interrupt 16;
void  S3_Routine(void) 		interrupt 17;
void  S4_Routine(void) 		interrupt 18;
void  Timer3_Routine(void) 	interrupt 19;
void  Timer4_Routine(void) 	interrupt 20;
void  Comparator_Routine(void) 	interrupt 21;
void  PWM_Routine(void) 	interrupt 22;
void  PWMFD_Routine(void) 	interrupt 23;